        #########                 #########        
    #####       #####         #####       #####    
  ###               ###     ###               ###  
 ##           s       ##   ##           s       ## 
##                     ## ##                     ##
#                       ###                       #
#            @                                    #
#                       ###                       #
##                     ## ##                     ##
 ##                   ##   ##                   ## 
  ###               ###     ###               ###  
    #####       #####         #####       #####    
        #### ####                 #### ####        
           # #                       # #
        #### ####                 #### ####        
    #####       #####         #####       #####    
  ###               ###     ###               ###  
 ##           s       ##   ##           s       ## 
##                     ## ##                     ##
#                       ###                       #
#                                                 #
###################################################                          
                                                                               
                                                                               
